0100tfn02tfn04ffn11ffn13tfn20ffn22tfn24ffn31ffn33ftn40ffn42ffn44ff
0200ffn02ffn04tfn11tfn13tfn20ffn22ffn24ftn31ffn33tfn40ffn42ffn44ff
0300ffn02ffn04ffn11ffn13ftn20ffn22tfn24ffn31ffn33tfn40tfn42tfn44ff
0400ffn02tfn04tfn11tfn13ffn20ffn22tfn24ffn31ftn33ffn40ffn42ffn44ff
0500ffn02ffn04ffn11tfn13tfn20ffn22ffn24ffn31tfn33ffn40tfn42ffn44ft
0600ffn02ffn04ffn11ftn13ffn20ffn22tfn24ffn31tfn33ffn40ffn42tfn44tf
0700tfn02ffn04ftn11tfn13tfn20ffn22tfn24ffn31ffn33ffn40ffn42ffn44ff
0800tfn02ffn04ffn11tfn13tfn20ffn22ffn24ftn31ffn33tfn40ffn42ffn44ff
0900ffn02ffn04tfn11ffn13tfn20ftn22tfn24ffn31ffn33tfn40ffn42ffn44ff
1000tfn02ffn04ftn11tfn13ffn20ffn22ffn24ffn31tfn33tfn40ffn42ffn44ff