0100ffn02ffn04ffn11ffn13ffn20ffn22ffn24ftn31tfn33tfn40tfn42ffn44ff
0200ffn02ffn04ffn11ffn13tfn20ffn22tfn24ftn31ffn33tfn40ffn42ffn44ff
0300ffn02ffn04ffn11ffn13ftn20ffn22tfn24ffn31ffn33tfn40ffn42ffn44tf
0400ffn02ffn04tfn11ffn13tfn20ffn22tfn24ffn31ffn33ftn40ffn42ffn44ff
0500ffn02ffn04tfn11tfn13tfn20ftn22ffn24ffn31ffn33ffn40ffn42ffn44ff
0600ffn02ffn04ftn11ffn13ffn20ffn22tfn24ffn31tfn33tfn40ffn42ffn44ff
0700ffn02ffn04ffn11tfn13tfn20ffn22tfn24ffn31ffn33ffn40ffn42ffn44ft
0800tfn02ffn04ffn11tfn13ffn20ffn22tfn24ffn31ftn33ffn40ffn42ffn44ff
0900ffn02ffn04ffn11ftn13ffn20ffn22tfn24ffn31tfn33ffn40tfn42ffn44ff
1000ffn02ffn04ffn11tfn13ffn20ffn22tfn24ftn31ffn33tfn40ffn42ffn44ff