0100tfn02ffn04ffn11tfn13ffn20tfn22tfn24ftn31tfn33ffn40ffn42ffn44ff
0200ffn02ffn04tfn11tfn13ffn20ffn22tfn24ftn31tfn33tfn40ffn42ffn44ff
0300tfn02ffn04ffn11tfn13ffn20ffn22tfn24ftn31tfn33tfn40ffn42ffn44ff
0400ffn02tfn04tfn11tfn13ffn20ffn22ffn24ffn31ftn33tfn40ffn42ffn44tf
0500ffn02ffn04tfn11ftn13tfn20ffn22ffn24ffn31tfn33ffn40ffn42tfn44tf
0600tfn02ffn04ftn11tfn13tfn20ffn22tfn24ffn31ffn33tfn40ffn42ffn44ff
0700ffn02ffn04ffn11ffn13tfn20ftn22tfn24tfn31ffn33tfn40ffn42ffn44tf
0800tfn02ffn04ftn11tfn13tfn20ffn22ffn24ffn31tfn33ffn40tfn42ffn44ff
0900ffn02ffn04ffn11ffn13tfn20ffn22tfn24ffn31tfn33tfn40tfn42ffn44ft
1000tfn02ffn04ffn11tfn13ftn20ffn22ffn24ffn31ffn33tfn40tfn42tfn44ff