0100ffn02ffn04ffn11ffn13tfn20ffn22ffn24ftn31tfn33ffn40tfn42tfn44tf
0200tfn02tfn04ffn11ffn13ftn20ffn22ffn24tfn31tfn33ffn40ffn42tfn44ff
0300ffn02ffn04ffn11ffn13ffn20tfn22tfn24tfn31ffn33tfn40ftn42tfn44ff
0400ffn02ffn04tfn11ffn13tfn20ftn22tfn24tfn31ffn33ffn40ffn42tfn44ff
0500ftn02tfn04ffn11ffn13tfn20tfn22tfn24tfn31ffn33ffn40ffn42ffn44ff
0600ffn02ffn04ffn11tfn13ffn20ftn22tfn24ffn31tfn33ffn40ffn42tfn44tf
0700ffn02ffn04tfn11ffn13tfn20ftn22tfn24tfn31ffn33ffn40ffn42tfn44ff
0800ffn02ffn04ffn11ffn13ffn20tfn22tfn24tfn31tfn33ffn40ffn42tfn44ft
0900ftn02tfn04ffn11ffn13tfn20tfn22tfn24tfn31ffn33ffn40ffn42ffn44ff
1000tfn02tfn04ffn11ffn13ftn20ffn22ffn24tfn31tfn33ffn40ffn42tfn44ff