0100ffn02ffn04ffn11ffn13tfn20ftn22tfn24ffn31ffn33ffn40tfn42ffn44ff
0200ffn02tfn04ffn11ffn13ffn20ffn22ffn24tfn31ffn33ffn40ftn42tfn44ff
0300ffn02ffn04ffn11ffn13tfn20ftn22tfn24ffn31ffn33ffn40tfn42ffn44ff
0400ffn02ffn04ffn11ffn13ftn20ffn22ffn24ffn31tfn33ffn40ffn42tfn44tf
0500ffn02tfn04ftn11ffn13ffn20tfn22ffn24ffn31ffn33ffn40ffn42tfn44ff
0600ffn02ffn04ffn11ffn13tfn20ffn22tfn24ftn31ffn33ffn40tfn42ffn44ff
0700ffn02ffn04ffn11ffn13tfn20ffn22tfn24ftn31ffn33ffn40tfn42ffn44ff
0800ffn02ffn04ffn11ffn13ftn20ffn22ffn24ffn31tfn33ffn40ffn42tfn44tf
0900ffn02ffn04ffn11ffn13tfn20ftn22tfn24ffn31ffn33ffn40tfn42ffn44ff
1000ffn02ffn04ffn11ffn13ftn20ffn22ffn24ffn31tfn33ffn40ffn42tfn44tf