0100ffn02ffn04ffn11ftn13ffn20ffn22tfn24ffn31tfn33ffn40ffn42tfn44tf
0200ffn02ffn04ffn11ffn13ffn20ffn22tfn24ffn31tfn33ftn40ffn42tfn44tf
0300ffn02ffn04ftn11ffn13tfn20ffn22tfn24tfn31ffn33ffn40ffn42tfn44ff
0400ffn02ffn04ffn11ftn13ffn20ffn22tfn24ffn31tfn33ffn40ffn42tfn44tf
0500ffn02ffn04ffn11ffn13tfn20ffn22tfn24ftn31ffn33ffn40ffn42tfn44tf
0600ffn02tfn04tfn11tfn13ftn20ffn22tfn24ffn31ffn33ffn40ffn42ffn44ff
0700ffn02ffn04ftn11ffn13tfn20ffn22tfn24tfn31ffn33ffn40ffn42tfn44ff
0800ffn02tfn04tfn11tfn13ftn20ffn22tfn24ffn31ffn33ffn40ffn42ffn44ff
0900ffn02ffn04ftn11ffn13tfn20ffn22tfn24tfn31ffn33ffn40ffn42tfn44ff
1000ffn02tfn04tfn11tfn13ftn20ffn22tfn24ffn31ffn33ffn40ffn42ffn44ff